===========
=         =
=    B    =
=         =
=         =
=         =
=         =
====   ====
   =   =
   =   =
   =   =     ====================
====   ===   =                  =
=        =====                  =
=                E         E    =
=                               =
=                     s         =
=        =====                  =
=        =   =    E        E    =
=            =                  =
==========   ====================
