
==========
=        =
=    B   =
=        =
=        =
=        =
=        =
====  ====
   =  =
   =  =
   =  =      ====================
====  ====   =                  =
=        =====                  =
=                               =
=                               =
=        =====        s         =
=        =   =                  =
=        =   =                  =
=        =   =                  =
==========   ====================
