goto-Level3.txt
=====*=====
=         =
=    B    =
=         =
=         =
=         =
=         =
====   ====
   =   =
   =   =
   =   =     ====================
====   ===   =                  =
=        =   =                  =
=        =====                  =
=                E              =
=                               =
=                     S         =
=        =====                  =
=        =   =                  =
=        =   =                  =
===   ====   ========    ========
  =   =             =    =
  =   =             =    =
  =   =             =    =
  =   =             =    =
  =   =             =    =
  =   =             =    = 
  =   =             =    =
  =   =             =    =
  =   =             =    ========
  =   =  ============           =
  =   =  =                      =
  =   =  =                      = 
  =   ====    E           E     =
  =                             =
  =                             =
  =                 E           =
  ========                      =
         =                      =
         ========================
    
