=====*=====
=         =
=    B    =
=         =
=         =
=         =
=         =
====   ====
   =   =
   =   =
   =   =     ====================
====   ===   =                  =
=        =   =                  =
=  EEEEE =====                  =
=                E         E    =
=                               =
=  EEEEE              s         =
=        =====                  =
=  EEEEE =   =    E        E    =
=        =   =                  =
==========   ====================
